$$$$$$$$$$$$$$$$
$@..#...#...#..$
$.#.$.#.$.#.$.#$
$...#...#...#..$
$.#.$.#.#.$.#.#$
$...#...$...#..$
$.#.#.#.#.#.$.#$
$...#.$.#......$
$.#.$.#.#.#.$..$
$...#...#...#..$
$$$$$$$$$$$$$$$$
