$$$$$$$$$$$$$$$$
$@.............$
$.#.#.#.#.#.#.#$
$..............$
$.#.#.#.#.#.#.#$
$..............$
$.#.#.#.#.#.#.#$
$..............$
$.#.#.#.#.#.#.#$
$..............$
$$$$$$$$$$$$$$$$
