$$$$$$$$$$$$$$$$
$@..#...#...#..$
$.#.#.#.#.#.#.#$
$...#...#...#..$
$.#.#.#.#.#.#.#$
$...#...#...#..$
$.#.#.#.#.#.#.#$
$...#...#......$
$.#.#.#.#.#.#..$
$...#...#...#..$
$$$$$$$$$$$$$$$$
